U Y U Y U Y U Y U Y U Y U 0 0 0 U Y U Y U Y U Y U Y U Y U Y U Y U Y U Y
Y 0 0 0 0 0 0 0 0 0 0 0 0 0 0 0 0 U Y 0 0 0 0 0 0 U Y 0 0 0 Y Y U U Y U
Y 0 0 0 0 0 0 U 0 0 0 0 0 0 0 0 0 U U U 0 0 0 0 0 U U 0 0 0 0 Y Y Y U Y
0 0 0 0 U U U U U U U 0 0 0 0 0 0 U Y U 0 0 0 0 0 0 0 0 0 0 Y 0 0 0 0 U
0 0 0 0 U U Y U U 0 0 0 0 0 0 0 0 Y U Y 0 0 0 0 0 0 0 0 0 Y 0 0 0 0 0 Y
U 0 0 0 U U U 0 0 0 0 0 0 0 0 0 0 Y Y 0 0 0 0 0 0 0 0 0 U 0 0 0 0 0 0 U
Y 0 0 0 U 0 0 0 0 0 0 0 0 0 0 0 0 0 0 0 0 0 0 0 0 0 0 Y 0 0 0 0 0 0 0 Y
U 0 0 0 U 0 0 0 0 0 0 0 0 0 0 0 0 0 0 0 0 0 0 0 0 0 Y 0 0 0 0 0 0 0 0 U
Y 0 0 0 U 0 0 0 0 0 0 0 0 0 0 0 0 0 0 0 0 0 0 0 0 0 U 0 0 0 0 0 0 0 0 Y
U 0 0 0 0 0 0 0 0 0 0 0 Y U Y Y Y 0 0 0 0 0 0 0 0 0 U 0 0 0 0 0 0 0 0 U
Y 0 0 0 0 0 0 0 0 0 0 0 Y Y Y U Y U 0 0 0 0 0 0 0 0 U 0 0 0 0 0 0 0 0 Y
U 0 0 0 0 0 0 U Y 0 0 0 0 0 U U U Y 0 0 0 0 0 0 0 0 U 0 0 0 0 U Y 0 0 U
Y 0 0 0 0 0 0 Y Y 0 0 0 0 0 Y Y Y Y 0 0 U U 0 0 0 0 U 0 0 0 0 U 0 0 0 Y
U 0 0 0 0 0 0 U Y 0 0 0 0 0 0 Y Y Y U Y Y Y 0 0 0 0 Y Y U U U Y 0 0 0 U
Y 0 0 0 0 0 0 0 Y U 0 0 0 0 0 0 U U U Y 0 0 0 0 0 0 U U Y 0 0 0 0 0 0 Y
U 0 0 0 0 0 0 0 U U Y 0 0 0 0 0 0 0 U Y U 0 0 0 0 0 Y U 0 0 0 0 0 0 0 U
Y 0 0 0 0 0 0 0 0 U U Y 0 0 0 0 0 0 0 U Y 0 0 0 0 0 0 0 0 0 0 0 0 0 0 Y
U 0 0 0 0 0 0 0 0 0 0 0 0 0 0 0 0 0 0 U U 0 0 0 0 0 0 0 0 0 0 0 0 0 0 U
Y 0 0 0 0 0 0 0 0 0 0 0 0 0 0 0 0 0 0 U U 0 0 0 0 0 0 Y U Y U Y U U U Y
U 0 0 0 Y U 0 0 0 0 0 0 0 0 Y Y U Y U Y 0 0 0 0 0 0 0 0 0 0 0 0 0 0 0 U
Y 0 0 0 U U Y 0 0 0 0 0 0 U U U U U Y Y U U 0 0 0 0 0 0 0 0 0 0 0 0 0 Y
U 0 0 0 U U 0 0 0 0 0 0 0 0 0 0 0 0 0 0 0 0 0 0 0 0 0 0 0 0 0 0 0 0 0 U
Y Y U U Y 0 0 0 0 0 0 0 0 0 0 0 0 0 0 0 0 0 0 0 0 0 0 0 0 0 0 0 0 0 0 Y
U Y U Y U Y U Y U Y U Y U Y 0 0 0 0 U Y U Y U Y U Y U Y U Y U Y U Y U Y