U Y U Y U Y U Y U Y U Y U Y 0 0 U Y U Y U Y U Y U Y U Y U Y U Y U Y U Y
U 0 0 0 0 0 0 0 0 0 0 0 0 0 0 0 0 0 0 0 0 0 0 0 0 0 0 0 0 0 0 0 0 0 0 U
Y 0 0 Y 0 0 Y 0 0 Y 0 0 Y 0 0 0 0 Y 0 0 Y 0 0 Y 0 0 Y 0 0 Y 0 0 Y 0 0 Y
0 0 0 0 0 0 0 0 0 0 0 0 0 0 0 0 0 0 0 0 0 0 0 0 0 0 0 0 0 0 0 0 0 0 0 0
0 0 0 0 0 0 0 0 0 0 0 0 0 0 0 0 0 0 0 0 0 0 0 0 0 0 0 0 0 0 0 0 0 0 0 0
Y F F F F F F F F F F F Y 0 0 0 0 Y 0 0 Y 0 0 Y 0 0 U F F F F F F F F U
Y 0 0 0 0 0 0 0 0 Y 0 0 0 0 0 0 0 0 0 0 0 0 0 0 0 0 U 0 0 0 0 0 0 0 0 U
Y 0 0 0 0 0 0 0 Y Y 0 0 0 0 0 0 0 0 0 0 0 0 0 0 0 0 U 0 0 0 0 0 0 0 0 U
Y 0 0 0 Y Y Y Y Y 0 0 0 0 0 0 0 0 0 0 0 0 0 0 0 0 0 U 0 0 0 0 0 0 0 0 U
Y 0 0 0 0 0 0 0 Y 0 0 0 0 0 0 0 0 0 0 0 0 0 0 0 0 0 U 0 0 0 0 0 0 0 0 U
Y 0 0 0 0 0 0 0 U 0 0 0 0 0 0 0 0 0 0 0 0 0 0 0 0 0 U 0 0 0 0 0 0 0 0 U
Y Y Y Y Y Y 0 0 Y 0 0 0 C C C C C C C C C C C 0 0 0 U 0 0 0 0 0 0 0 0 U
Y 0 0 0 0 0 0 0 Y 0 0 0 C C C C C C C C C C C 0 0 0 U 0 0 0 0 0 0 0 0 U
Y 0 0 0 0 0 0 0 Y 0 0 0 C C C C C C C C C C C 0 0 0 U 0 0 0 0 0 0 0 0 U
Y 0 0 Y Y Y Y Y U 0 0 0 C C C C C C C C C C C 0 0 0 U F F F F F F F F U
Y 0 0 0 0 0 0 0 0 0 0 0 C C C C C C C C C C C 0 0 0 0 0 0 0 0 0 0 0 0 Y
Y 0 0 0 0 0 0 0 0 0 0 0 0 0 0 0 0 0 0 0 0 0 0 0 0 0 0 0 0 0 0 0 0 0 0 Y
Y 0 0 0 0 0 0 0 0 0 0 0 0 0 0 0 0 0 0 0 0 0 0 0 0 0 0 0 0 0 0 0 0 0 0 Y
F F F F F F F F U 0 0 0 0 0 0 0 0 0 0 0 0 0 0 0 0 0 U F F F F F F F F F
U 0 0 0 0 0 0 0 0 0 0 0 0 0 0 0 0 0 0 0 0 0 0 0 0 0 0 0 0 0 0 0 0 0 0 Y
U 0 0 0 0 0 0 0 0 0 0 0 0 0 0 0 0 0 0 0 0 0 0 0 0 0 0 0 0 0 0 0 0 0 0 U
U 0 0 0 0 0 0 0 0 0 0 0 0 0 0 0 0 0 0 0 0 0 0 0 0 0 0 0 0 0 0 0 0 0 0 Y
U 0 0 0 0 0 0 0 0 0 0 0 0 0 0 0 0 0 0 0 0 0 0 0 0 0 0 0 0 0 0 0 0 0 0 U
U Y U Y U Y U Y U Y U Y U Y 0 0 U Y U Y U Y U Y U Y U Y U Y U Y U Y U Y