U U U U U U U U U U U U U U 0 0 0 U U U U U U U U U U U U U U U U U U U
U 0 0 0 0 0 0 0 0 0 0 0 0 0 0 0 0 0 0 0 0 0 0 0 0 0 0 0 0 0 0 0 0 0 0 U
U 0 0 0 0 0 0 0 0 0 0 0 0 0 0 0 0 0 0 0 0 0 0 0 0 0 0 0 0 0 0 0 0 0 0 U
U 0 0 0 Y 0 0 0 Y 0 0 0 Y 0 0 0 Y 0 0 0 Y 0 0 0 Y 0 0 0 Y 0 0 0 0 0 0 U
U 0 0 0 Y 0 0 0 Y 0 0 0 Y 0 0 0 Y 0 0 0 Y 0 0 0 Y 0 0 0 Y 0 0 0 0 0 0 U
U 0 0 0 Y 0 0 0 Y 0 0 0 Y 0 0 0 Y 0 0 0 Y 0 0 0 Y 0 0 0 Y 0 0 0 0 0 0 U
U 0 0 0 Y 0 0 0 Y 0 0 0 Y 0 0 0 Y 0 0 0 Y 0 0 0 Y 0 0 0 Y 0 0 0 0 0 0 U
U 0 0 0 Y 0 0 0 Y 0 0 0 Y 0 0 0 Y 0 0 0 Y 0 0 0 Y 0 0 0 Y 0 0 0 0 0 0 U
U 0 0 0 Y 0 0 0 Y 0 0 0 Y 0 0 0 Y 0 0 0 Y 0 0 0 Y 0 0 0 Y 0 0 0 0 0 0 U
U 0 0 0 Y 0 0 0 Y 0 0 0 Y 0 0 0 Y 0 0 0 Y 0 0 0 Y 0 0 0 Y 0 0 0 0 0 0 U
U 0 0 0 Y 0 0 0 Y 0 0 0 Y 0 0 0 Y 0 0 0 Y 0 0 0 Y 0 0 0 Y 0 0 0 0 0 0 U
U 0 0 0 Y 0 0 0 Y 0 0 0 Y 0 0 0 Y 0 0 0 Y 0 0 0 Y 0 0 0 Y 0 0 0 0 0 0 U
U 0 0 0 Y 0 0 0 Y 0 0 0 Y 0 0 0 Y 0 0 0 Y 0 0 0 Y 0 0 0 Y 0 0 0 0 0 0 U
U 0 0 0 Y 0 0 0 Y 0 0 0 Y 0 0 0 Y 0 0 0 Y 0 0 0 Y 0 0 0 Y 0 0 0 0 0 0 U
U 0 0 0 Y 0 0 0 Y 0 0 0 Y 0 0 0 Y 0 0 0 Y 0 0 0 Y 0 0 0 Y 0 0 0 0 0 0 0
U 0 0 0 Y 0 0 0 Y 0 0 0 Y 0 0 0 Y 0 0 0 Y 0 0 0 Y 0 0 0 Y 0 0 0 0 0 0 0
U 0 0 0 Y 0 0 0 Y 0 0 0 Y 0 0 0 Y 0 0 0 Y 0 0 0 Y 0 0 0 Y 0 0 0 0 0 0 0
U 0 0 0 Y 0 0 0 Y 0 0 0 Y 0 0 0 Y 0 0 0 Y 0 0 0 Y 0 0 0 Y 0 0 0 0 0 0 0
U 0 0 0 Y 0 0 0 Y 0 0 0 Y 0 0 0 Y 0 0 0 Y 0 0 0 Y 0 0 0 Y 0 0 0 0 0 0 U
U 0 0 0 Y 0 0 0 Y 0 0 0 Y 0 0 0 Y 0 0 0 Y 0 0 0 Y 0 0 0 Y 0 0 0 0 0 0 U
U 0 0 0 0 0 0 0 0 0 0 0 0 0 0 0 0 0 0 0 0 0 0 0 0 0 0 0 0 0 0 0 0 0 0 U
U 0 0 0 0 0 0 0 0 0 0 0 0 0 0 0 0 0 0 0 0 0 0 0 0 0 0 0 0 0 0 0 0 0 0 U
U 0 0 0 0 0 0 0 0 0 0 0 0 0 0 0 0 0 0 0 0 0 0 0 0 0 0 0 0 0 0 0 0 0 0 U
U U U U U U U U U U U U U U U U U U U U U U U U U U U U U U U U U U U U