U U U U U U U U U U U U U U 0 0 0 U U U U U U U U U U U U U U U U U U U
U 0 0 Y 0 0 0 0 0 Y 0 0 0 0 0 0 0 0 0 0 0 Y 0 0 0 0 0 Y 0 0 0 0 0 Y 0 U
U 0 0 0 0 0 Y 0 0 0 0 0 Y 0 0 0 0 0 Y 0 0 0 0 0 Y 0 0 0 0 0 Y 0 0 0 0 U
U F F F F F F F F F F F F F 0 0 0 F F F F F F F F F F F F F F F F F F U
U 0 0 0 0 0 0 0 0 0 0 0 0 0 0 0 0 0 0 0 0 0 0 0 0 0 0 0 0 0 0 0 0 0 0 U
U 0 0 0 0 0 0 0 0 0 0 0 0 0 0 0 0 0 0 0 0 0 0 0 0 0 0 0 0 0 0 0 0 0 0 U
U 0 0 0 0 0 0 0 0 0 0 0 0 0 0 0 0 0 0 0 0 0 0 0 0 0 0 0 0 0 0 0 0 0 0 U
U 0 0 0 0 0 0 0 0 0 0 0 0 0 0 0 0 0 0 0 0 0 0 0 0 0 0 0 0 0 0 0 0 0 0 U
U 0 0 0 0 0 0 0 0 0 0 0 0 0 0 0 0 0 U U U U 0 0 0 0 0 0 0 0 0 0 0 0 0 U
U 0 0 0 0 0 0 0 0 0 0 0 0 0 0 0 0 0 0 0 0 0 0 0 0 0 0 0 0 0 0 0 0 0 0 U
U 0 0 0 0 0 0 0 0 0 0 0 0 0 0 0 0 0 0 0 0 0 0 0 0 0 0 0 0 0 0 0 0 0 0 U
U 0 0 0 0 U U U U 0 0 0 0 0 0 0 0 0 0 0 0 0 0 0 0 0 0 0 0 0 0 0 0 0 0 U
U 0 0 0 0 0 0 0 0 0 0 0 0 0 0 0 0 0 0 0 0 0 0 0 0 0 0 0 0 0 0 0 0 0 0 U
U 0 0 0 0 0 0 0 0 0 0 0 0 0 0 0 0 0 0 0 0 0 0 0 0 0 0 0 0 0 0 0 0 0 0 U
U 0 0 0 0 0 0 0 0 0 0 0 0 0 0 0 0 0 0 0 0 U U U U U 0 0 0 0 0 0 0 0 0 U
0 0 0 0 0 0 0 0 0 0 0 0 0 0 0 0 0 0 0 0 0 0 0 0 0 0 0 0 0 0 0 0 0 0 0 U
0 0 0 0 0 0 0 0 0 0 0 0 0 0 0 0 0 0 0 0 0 0 0 0 0 0 0 0 0 0 0 0 0 0 0 U
0 0 0 0 0 0 0 0 0 0 U U U U 0 0 0 0 0 0 0 0 0 0 0 0 0 0 0 0 0 0 0 0 0 U
U 0 0 0 0 0 0 0 0 0 0 0 0 0 0 0 0 0 0 0 0 0 0 0 0 0 0 0 0 0 0 0 0 0 0 U
U 0 0 0 0 0 0 0 0 0 0 0 0 0 0 0 0 0 0 0 0 0 0 0 0 0 0 0 0 0 0 0 0 0 0 U
U F F F F F F F F F F F F F 0 0 0 F F F F F F F F F F F F F F F F F F U
U 0 0 Y 0 0 0 0 0 Y 0 0 0 0 0 0 0 0 0 0 0 Y 0 0 0 0 0 Y 0 0 0 0 0 0 0 U
U 0 0 0 0 0 Y 0 0 0 0 0 Y 0 0 0 0 0 Y 0 0 0 0 0 Y 0 0 0 0 0 Y 0 0 0 0 U
U U U U U U U U U U U U U U 0 0 0 U U U U U U U U U U U U U U U U U U U