G G G G G G G G G G G G G G Q Q G G G G G G G G G G G G G G G G G G G G
G G G G G G G G G G G G G G Q Q G G G G G G G G G G G G G G G G G G G G
G G G G G G G G G G G G G G Q Q G G G G G G G G G G G G G G G G G G G G
Q Q Q Q Q Q Q Q Q Q Q Q Q Q Q Q Q Q Q Q Q Q Q Q Q Q Q Q Q Q Q Q Q Q Q Q
Q Q Q Q Q Q Q Q Q Q Q Q Q Q Q Q Q Q Q Q Q Q Q Q Q Q Q Q Q Q Q Q Q Q Q Q
G G G G G G G G G G G G G G Q Q G G G G G G G G G G G G G G G G G G G G
G G G G G G G G G G G G G G Q Q G G G G G G G G G G G G G G G G G G G G
G G G G G G G G G G G G G G Q Q G G G G G G G G G G G G G G G G G G G G
G G G G G G G G G Q Q Q Q Q Q Q Q Q Q Q Q Q Q Q Q Q G G G G G G G G G G
G G G G G G G G G Q Q Q Q Q Q Q Q Q Q Q Q Q Q Q Q Q G G G G G G G G G G
G G G G G G G G G Q Q G G G G G G G G G G G G G Q Q G G G G G G G G G G
G G G G G G G G G Q Q G C C C C C C C C C C C G Q Q G G G G G G G G G G
G G G G G G G G G Q Q G C C C C C C C C C C C G Q Q G G G G G G G G G G
G G G G G G G G G Q Q G C C C C C C C C C C C G Q Q G G G G G G G G G G
G G G G G G G G G Q Q G C C C C C C C C C C C G Q Q G G G G G G G G G G
G G G G G G G G G Q Q G C C C C C C C C C C C G Q Q G G G G G G G G G G
G G G G G G G G G Q Q G G G G G G G G G G G G G Q Q G G G G G G G G G G
G G G G G G G G G Q Q Q Q Q Q Q Q Q Q Q Q Q Q Q Q Q G G G G G G G G G G
G G G G G G G G G Q Q Q Q Q Q Q Q Q Q Q Q Q Q Q Q Q G G G G G G G G G G
G G G G G G G G G G G G G G Q Q G G G G G G G G G G G G G G G G G G G G
G G G G G G G G G G G G G G Q Q G G G G G G G G G G G G G G G G G G G G
G G G G G G G G G G G G G G Q Q G G G G G G G G G G G G G G G G G G G G
G G G G G G G G G G G G G G Q Q G G G G G G G G G G G G G G G G G G G G
G G G G G G G G G G G G G G Q Q G G G G G G G G G G G G G G G G G G G G